36  120
0  0  0  0  0  0  0  0  0  0  0  0  0  0  0  0  0  0  0  0  0  0  0  0  0  0  0  0  0  0  0  0  0  0  0  0  0  0  0  0  0  0  0  0  0  0  0  0  0  0  0  0  0  0  0  0  0  0  0  0  0  0  0  0  0  0  0  0  0  0  0  0  0  0  0  0  0  0  0  0  0  0  0  0  0  0  0  0  0  0  0  0  0  0  0  0  0  0  0  0  0  0  0  0  0  0  0  0  0  0  0  0  0  0  0  0  0  0  0  0
0  0  0  0  0  0  0  0  0  0  0  0  0  0  0  0  0  0  0  0  0  0  0  0  0  0  0  0  0  0  0  0  0  0  0  0  0  0  0  0  0  0  0  0  0  0  0  0  0  0  0  0  0  0  0  0  0  0  0  0  0  0  0  0  0  0  0  0  0  0  0  0  0  0  0  6  1  1  1  1  1  1  1  1  1  1  1  1  1  1  1  1  1  1  1  1  1  1  1  1  1  1  1  1  1  1  1  1  1  1  1  1  1  1  8  0  0  0  0  0
0  0  0  0  0  0  0  0  0  0  0  0  0  0  0  0  0  0  0  0  0  0  0  0  0  0  0  0  0  0  0  0  0  0  6  1  1  1  1  1  1  1  1  1  1  1  1  1  1  1  1  1  1  1  1  8  0  0  0  0  0  0  0  0  0  0  0  0  0  0  0  0  0  0  0  2  11 11 11 11 11 11 11 11 11 11 11 11 11 11 11 11 11 11 11 11 11 11 11 11 11 11 11 11 11 11 11 11 11 11 11 11 11 11 2  0  0  0  0  0
0  0  0  0  0  0  0  0  0  0  0  0  0  0  0  0  0  0  0  0  0  0  0  0  0  0  0  0  0  0  0  0  0  0  2  3  3  3  6  1  1  1  1  1  1  1  1  1  1  1  1  1  1  8  3  2  0  0  0  0  0  0  0  0  0  0  0  0  0  0  0  0  0  0  0  2  11 11 11 11 11 11 7  7  7  11 11 11 7  7  7  11 11 11 6  1  1  1  1  1  8  11 11 7  7  7  7  7  7  7  7  7  7  11 2  0  0  0  0  0
0  0  0  0  0  0  0  0  0  0  0  0  0  0  0  0  0  0  0  0  0  0  0  0  0  0  0  0  0  0  0  0  0  0  2  3  3  3  2  7  7  7  7  7  7  7  7  7  7  7  7  7  7  2  3  2  0  6  1  1  1  1  1  1  1  1  1  1  1  1  1  1  1  1  1  10 1  1  1  1  8  11 7  7  7  11 11 11 7  7  7  11 11 11 2  3  3  3  3  3  2  11 11 11 11 11 11 11 11 11 11 11 11 11 2  0  0  0  0  0
0  0  0  0  0  0  0  0  0  0  0  0  0  0  0  0  0  0  0  0  0  0  0  0  0  0  0  0  0  0  0  0  0  0  2  3  3  3  2  7  7  7  7  7  7  7  7  7  7  7  7  7  7  2  3  2  0  2  7  7  7  7  7  7  7  7  7  7  7  7  7  7  7  7  7  7  7  7  7  7  2  11 7  7  7  11 11 11 7  7  7  11 11 11 2  3  3  3  3  3  2  11 11 11 11 11 11 11 11 11 11 11 11 11 2  0  0  0  0  0
0  0  0  0  0  0  0  0  0  0  0  0  0  0  0  0  0  0  0  0  0  0  0  0  6  1  1  1  8  0  6  1  1  1  2  3  3  3  9  1  1  1  1  1  1  1  1  1  1  1  1  1  1  10 3  2  0  2  7  7  7  7  7  7  7  7  7  7  7  7  7  7  7  7  7  7  7  7  7  7  2  11 7  7  7  11 11 11 7  7  7  11 11 11 2  3  3  3  3  3  2  11 11 7  7  7  7  7  7  7  7  7  7  11 2  0  0  0  0  0
0  0  0  0  0  0  0  0  0  0  0  0  0  0  0  0  0  0  0  0  0  0  0  0  2  7  7  7  2  0  2  7  7  7  2  3  3  3  3  3  3  3  3  3  6  1  1  1  1  1  1  1  1  1  1  10 1  10 7  7  7  7  1  1  6  1  1  1  1  1  1  1  1  1  1  8  7  7  7  7  2  11 7  7  7  11 11 11 7  7  7  11 11 11 2  3  3  3  3  3  2  11 11 11 11 11 11 11 11 11 11 11 11 11 2  0  0  0  0  0
0  0  0  0  0  0  0  0  0  0  0  0  0  0  0  0  0  0  0  0  0  0  0  0  2  7  7  7  2  0  2  7  7  7  2  3  3  3  3  3  3  3  3  3  2  3  3  3  3  3  3  3  3  3  3  7  7  7  7  7  7  7  7  7  2  0  0  0  0  0  0  0  0  0  0  2  7  7  7  7  2  11 7  7  7  11 11 11 7  7  7  11 11 11 2  3  3  3  3  3  2  11 11 11 11 7  7  7  7  7  7  7  7  11 2  0  0  0  0  0
0  0  0  0  0  0  0  0  0  0  0  0  0  0  0  0  0  0  0  0  0  0  0  0  2  7  7  7  2  0  2  7  7  7  2  3  3  3  3  3  3  3  3  3  2  3  3  3  3  3  3  3  3  3  3  7  7  7  7  7  7  7  7  7  2  0  0  0  0  0  0  0  0  0  0  2  7  7  7  7  2  11 11 11 11 11 11 11 11 11 11 11 11 11 9  1  1  1  1  1  10 11 11 11 11 7  7  7  7  7  7  7  7  11 2  0  0  0  0  0
0  0  0  6  1  1  1  1  1  1  1  8  0  0  0  0  0  0  0  0  0  0  0  0  2  7  7  7  2  0  2  7  7  7  2  3  3  3  3  3  3  3  3  3  2  1  1  1  1  1  1  1  1  1  1  2  7  7  7  7  7  7  7  7  2  0  0  0  0  0  0  0  0  0  0  2  7  7  7  7  2  11 11 11 11 11 11 11 11 11 11 11 11 11 11 11 11 11 11 11 11 11 11 11 11 11 11 7  7  7  7  11 11 11 2  0  0  0  0  0
0  0  0  2  5  5  5  5  5  5  5  2  0  0  0  0  0  0  0  0  0  0  0  0  2  7  7  7  2  0  2  7  7  7  2  3  3  3  3  3  3  3  3  3  2  3  3  3  3  3  3  3  3  3  3  7  7  7  7  7  7  7  7  7  2  0  0  0  0  0  0  0  0  0  0  9  8  7  7  7  2  1  1  1  1  1  1  1  1  1  1  1  1  1  1  1  1  1  1  1  1  1  1  1  1  1  8  7  7  7  7  6  1  1  10 0  0  0  0  0
0  0  0  2  5  5  5  5  5  5  5  2  0  0  0  0  0  0  0  0  0  0  0  0  2  7  7  7  2  0  2  7  7  7  2  3  3  3  3  3  3  3  3  3  2  3  3  3  3  3  3  3  3  3  3  7  7  7  7  7  7  7  7  7  2  0  0  0  0  0  0  0  0  0  0  0  2  7  7  7  2  0  0  0  0  0  0  0  0  0  0  0  0  0  0  0  0  0  0  0  0  0  0  0  0  0  2  0  0  0  0  2  0  0  0  0  0  0  0  0
0  0  0  2  5  5  5  5  5  5  5  9  1  1  1  1  1  1  1  1  1  1  1  1  10 1  1  1  9  1  10 1  1  1  9  1  1  1  1  1  1  1  1  1  9  1  1  1  1  1  1  1  1  1  1  1  8  7  7  7  7  6  1  1  10 0  0  0  0  0  0  0  0  0  0  0  2  7  7  7  2  0  0  0  0  0  0  0  0  0  0  0  0  0  0  0  0  0  0  0  0  0  0  0  0  0  2  0  0  0  0  2  0  0  0  0  0  0  0  0
0  0  0  2  5  5  5  5  5  5  5  7  7  7  7  7  7  7  7  7  7  7  7  7  7  7  7  7  7  7  7  7  7  7  2  0  0  0  0  0  0  0  0  0  0  0  0  0  0  0  0  0  0  0  0  0  2  7  7  7  7  2  0  0  0  0  0  0  0  6  1  1  1  1  1  1  10 7  7  7  2  0  0  0  0  0  0  0  0  0  0  0  0  0  0  0  0  0  0  0  0  0  0  0  0  0  2  0  0  0  0  2  0  0  0  0  0  0  0  0
0  0  0  2  5  5  5  5  5  5  5  7  7  7  7  7  7  7  7  7  7  7  7  7  7  7  7  7  7  7  7  7  7  7  2  0  0  0  0  0  0  0  0  0  0  0  0  0  0  0  0  0  0  0  0  0  2  7  7  7  7  2  0  0  0  0  0  0  0  2  7  7  7  7  7  7  7  7  7  7  2  0  0  0  0  0  0  0  0  0  0  0  0  0  0  0  0  0  0  6  1  1  1  1  1  1  10 0  0  0  0  9  1  1  1  1  1  8  0  0
0  0  0  2  5  5  5  5  5  5  5  6  1  8  7  7  7  7  7  7  7  7  7  7  7  7  7  7  7  7  7  7  7  7  2  0  0  0  0  0  0  0  0  0  0  0  0  0  0  0  0  0  0  0  0  0  2  7  7  7  7  2  0  0  0  0  0  0  0  2  7  7  7  6  1  1  1  1  1  1  10 0  0  0  0  0  0  0  0  0  0  0  0  0  0  0  0  0  0  2  0  0  0  0  0  0  0  0  0  0  0  0  0  0  0  0  0  2  0  0
0  0  0  9  1  1  1  1  1  1  1  10 0  2  7  3  7  3  3  3  3  3  3  3  3  3  3  7  7  7  7  7  7  7  2  0  0  0  0  0  0  0  0  0  0  0  0  0  0  0  0  0  0  0  0  0  2  7  7  7  7  2  0  0  0  0  0  0  0  2  7  7  7  2  0  0  0  0  0  0  0  0  0  0  6  1  1  1  1  1  1  1  1  1  1  1  1  1  1  10 0  0  0  0  0  0  0  0  0  0  0  0  0  0  0  0  0  2  0  0
0  0  0  0  0  0  0  0  0  0  0  0  0  2  7  3  7  3  6  1  1  1  1  1  1  1  1  1  1  1  1  1  1  1  10 0  0  0  0  0  0  0  0  0  0  0  0  0  0  0  0  0  0  0  0  0  2  7  7  7  7  2  0  0  0  0  0  0  0  2  7  7  7  2  0  0  0  0  0  0  0  0  0  0  2  0  0  0  0  0  0  0  0  0  0  0  0  0  0  0  0  0  0  0  0  0  0  0  0  0  0  0  0  0  0  0  0  2  0  0
0  0  0  0  0  0  0  0  0  0  0  0  0  2  7  3  7  3  2  0  0  0  0  0  0  0  0  0  0  0  0  0  0  0  0  0  0  0  0  0  6  1  1  1  1  1  1  1  1  1  1  1  1  1  1  1  2  7  7  7  7  9  1  1  1  1  1  1  1  10 7  7  7  2  1  1  1  8  0  0  0  0  0  0  2  0  0  0  0  0  0  0  0  0  0  0  0  0  0  0  0  0  0  0  0  0  0  0  0  0  0  0  0  0  0  0  0  2  0  0
0  0  0  6  1  1  1  1  1  1  1  8  0  2  7  3  7  3  2  0  0  0  0  0  0  0  0  0  0  0  0  0  0  0  0  0  0  0  0  0  2  0  0  0  0  0  0  0  0  0  0  0  0  0  0  0  2  7  7  7  7  7  7  7  7  7  7  7  7  7  7  7  7  2  0  0  0  2  0  0  0  0  0  0  2  0  0  0  0  6  1  1  1  1  1  1  1  1  1  8  0  0  0  0  0  0  0  0  0  0  0  0  0  0  0  0  0  2  0  0
0  0  0  2  4  4  4  4  4  4  4  9  1  10 7  3  7  3  2  0  0  0  0  0  0  0  0  0  0  0  0  0  0  0  0  0  0  0  0  0  2  0  0  0  7  7  7  7  7  7  7  7  7  7  7  0  2  7  7  7  7  7  7  7  7  7  7  7  7  7  7  7  7  2  0  0  0  2  0  0  0  0  0  0  2  0  0  0  0  2  0  0  0  0  0  0  0  0  0  2  0  0  0  0  0  0  0  0  0  0  0  0  0  0  0  0  0  2  0  0
0  0  0  2  4  4  4  4  4  4  4  7  7  7  7  7  7  3  2  0  0  0  0  0  0  0  0  0  0  0  0  0  0  0  0  0  0  0  0  0  2  0  0  0  7  7  7  7  7  7  7  7  7  7  7  0  9  1  1  1  1  1  1  1  1  1  1  1  1  1  1  1  1  10 0  0  0  2  0  0  0  0  0  0  2  0  0  0  0  2  0  0  0  0  0  0  0  0  0  2  0  0  0  0  0  0  0  0  0  0  0  0  0  0  0  0  0  2  0  0
0  0  0  2  4  4  4  4  4  4  4  7  7  7  7  7  7  3  2  0  0  0  0  0  0  0  0  0  0  0  0  0  0  0  0  0  0  0  0  0  2  0  0  0  0  0  0  0  0  0  0  0  0  0  0  0  0  0  0  0  0  0  0  0  0  0  0  0  0  0  0  0  0  0  0  0  0  2  0  0  0  0  0  0  2  0  0  0  0  2  0  0  0  0  0  0  0  0  0  9  1  1  1  1  1  1  1  1  1  1  1  1  1  1  1  1  1  10 0  0
0  0  0  2  4  4  4  4  4  4  4  6  1  8  7  3  7  3  2  0  0  0  0  0  0  0  0  0  0  0  0  0  0  0  0  0  0  0  0  0  2  0  0  0  7  7  7  7  7  7  7  7  7  7  7  0  0  0  0  0  0  0  0  0  0  0  0  0  0  0  0  0  0  0  0  0  0  2  0  0  0  0  0  0  2  0  0  0  0  2  0  0  0  0  0  0  0  0  0  0  0  0  0  0  0  0  0  0  0  0  0  0  0  0  0  0  0  0  0  0
0  0  0  2  4  4  4  4  4  4  4  2  0  2  7  3  7  3  2  0  0  0  0  0  0  0  0  0  0  0  0  0  0  0  0  0  0  0  0  0  2  0  0  0  7  7  7  7  7  7  7  7  7  7  7  0  0  0  0  0  6  1  1  1  1  1  1  1  1  1  8  0  0  0  0  0  0  2  0  0  0  0  0  0  2  0  0  0  0  2  0  0  0  0  0  0  0  0  0  0  0  0  0  0  0  0  0  0  0  0  0  0  0  0  0  0  0  0  0  0
0  0  0  2  4  4  4  4  4  4  4  2  0  2  7  3  7  3  2  0  0  0  0  0  0  0  0  0  0  0  0  0  0  0  0  0  0  0  0  0  2  0  0  0  0  0  0  0  0  0  0  0  0  0  0  0  0  0  0  0  2  0  0  0  0  0  0  0  0  0  2  0  0  0  0  0  0  2  0  0  0  0  0  0  2  0  0  0  0  2  0  0  0  0  0  0  0  0  0  0  0  0  0  0  0  0  0  0  0  0  0  0  0  0  0  0  0  0  0  0
0  0  0  9  1  1  1  1  1  1  1  10 0  2  7  3  7  3  2  0  0  0  0  0  0  0  0  0  0  0  0  0  0  0  0  0  0  0  0  0  2  0  0  0  7  7  7  7  7  7  7  7  7  7  7  0  0  0  0  0  2  0  0  0  0  0  0  0  0  0  9  1  1  1  1  1  1  9  1  1  1  1  1  1  10 0  0  0  0  2  0  0  0  0  0  0  0  0  0  0  0  0  0  0  0  0  0  0  0  0  0  0  0  0  0  0  0  0  0  0
0  0  0  0  0  0  0  0  0  0  0  0  0  2  7  3  7  3  2  0  0  0  0  0  0  0  0  0  0  0  0  0  0  0  0  0  0  0  0  0  2  0  0  0  7  7  7  7  7  7  7  7  7  7  7  0  0  0  0  0  2  0  0  0  0  0  0  0  0  0  0  0  0  0  0  0  0  0  0  0  0  0  0  0  0  0  0  0  0  2  0  0  0  0  0  0  0  0  0  0  0  0  0  0  0  0  0  0  0  0  0  0  0  0  0  0  0  0  0  0
0  0  0  0  0  0  0  0  0  0  0  0  0  2  7  3  7  3  2  0  0  0  0  0  0  0  0  0  0  0  0  0  0  0  0  0  0  0  0  0  2  0  0  0  0  0  0  0  0  0  0  0  0  0  0  0  0  0  0  0  2  0  0  0  0  0  0  0  0  0  0  0  0  0  0  0  0  0  0  0  0  0  0  0  0  0  0  0  0  2  0  0  0  0  0  0  0  0  0  0  0  0  0  0  0  0  0  0  0  0  0  0  0  0  0  0  0  0  0  0
0  0  0  6  1  1  1  1  1  1  1  1  1  10 7  3  7  3  2  0  0  0  0  0  0  0  0  0  0  0  0  0  0  0  0  0  0  0  0  0  2  0  0  0  7  7  7  7  7  7  7  7  7  7  7  0  0  0  0  0  2  0  0  0  0  0  0  0  0  0  6  1  1  1  1  1  1  6  1  1  1  1  1  1  1  1  1  1  1  10 0  0  0  0  0  0  0  0  0  0  0  0  0  0  0  0  0  0  0  0  0  0  0  0  0  0  0  0  0  0
0  0  0  2  7  7  7  7  7  7  7  7  7  7  7  3  7  3  2  0  0  0  0  0  0  0  0  0  0  0  0  0  0  0  0  0  0  0  0  0  2  0  0  0  7  7  7  7  7  7  7  7  7  7  7  0  0  0  0  0  9  1  1  1  1  1  1  1  1  1  10 0  0  0  0  0  0  2  0  0  0  0  0  0  0  0  0  0  0  0  0  0  0  0  0  0  0  0  0  0  0  0  0  0  0  0  0  0  0  0  0  0  0  0  0  0  0  0  0  0
0  0  0  2  7  7  7  7  7  7  7  7  7  7  7  7  7  3  2  0  0  0  0  0  0  0  0  0  0  0  0  0  0  0  0  0  0  0  0  0  2  0  0  0  0  0  0  0  0  0  0  0  0  0  0  0  0  0  0  0  0  0  0  0  0  0  0  0  0  0  0  0  0  0  0  0  0  2  0  0  0  0  0  0  0  0  0  0  0  0  0  0  0  0  0  0  0  0  0  0  0  0  0  0  0  0  0  0  0  0  0  0  0  0  0  0  0  0  0  0
0  0  0  2  7  7  7  7  7  7  7  7  7  3  3  3  3  3  2  0  0  0  0  0  0  0  0  0  0  0  0  0  0  0  0  0  0  0  0  0  9  1  1  1  1  1  1  1  1  1  1  1  1  1  1  1  1  1  1  1  1  1  1  1  1  1  1  1  1  1  1  1  1  1  1  1  1  10 0  0  0  0  0  0  0  0  0  0  0  0  0  0  0  0  0  0  0  0  0  0  0  0  0  0  0  0  0  0  0  0  0  0  0  0  0  0  0  0  0  0
0  0  0  9  1  1  1  1  1  1  1  1  1  1  1  1  1  1  10 0  0  0  0  0  0  0  0  0  0  0  0  0  0  0  0  0  0  0  0  0  0  0  0  0  0  0  0  0  0  0  0  0  0  0  0  0  0  0  0  0  0  0  0  0  0  0  0  0  0  0  0  0  0  0  0  0  0  0  0  0  0  0  0  0  0  0  0  0  0  0  0  0  0  0  0  0  0  0  0  0  0  0  0  0  0  0  0  0  0  0  0  0  0  0  0  0  0  0  0  0
0  0  0  0  0  0  0  0  0  0  0  0  0  0  0  0  0  0  0  0  0  0  0  0  0  0  0  0  0  0  0  0  0  0  0  0  0  0  0  0  0  0  0  0  0  0  0  0  0  0  0  0  0  0  0  0  0  0  0  0  0  0  0  0  0  0  0  0  0  0  0  0  0  0  0  0  0  0  0  0  0  0  0  0  0  0  0  0  0  0  0  0  0  0  0  0  0  0  0  0  0  0  0  0  0  0  0  0  0  0  0  0  0  0  0  0  0  0  0  0

0  1  2  3  4  5  6  7  8  9  10

